1,1,1,1,1,1,1,1,3,1,1,1,1,1,1,1,1,1,1,1
1,13,0,0,0,0,0,0,0,0,0,0,0,0,0,0,0,0,0,1
1,0,0,0,0,0,0,0,0,0,0,0,0,0,0,2,0,0,0,1
1,1,1,1,1,1,1,1,1,1,1,1,1,1,12,1,1,1,1,1
1,22,22,19,19,2,20,20,21,21,1,0,0,0,15,2,0,0,0,1
1,22,22,19,19,0,20,20,21,21,1,0,0,0,0,0,0,0,0,1
1,22,22,19,19,0,20,20,21,21,1,0,0,0,0,0,0,0,0,1
1,1,1,1,1,1,1,1,1,1,1,0,0,0,0,0,0,0,0,1
1,2,0,0,1,15,0,0,0,0,1,1,1,1,1,1,1,1,1,1
1,0,0,0,1,0,0,0,0,0,0,0,0,1,0,0,0,0,0,1
1,0,0,15,1,15,0,0,0,0,0,0,0,1,0,0,0,0,0,1
1,0,0,0,1,0,0,0,0,2,0,14,0,1,0,0,0,0,0,1
1,0,0,0,1,0,0,0,0,0,0,0,0,1,0,0,0,0,0,1
1,1,18,1,1,1,1,1,1,0,0,0,0,1,0,0,0,0,0,1
1,0,0,0,0,0,22,22,1,1,1,1,1,1,0,0,0,0,0,1
1,0,0,0,0,0,2,22,1,18,0,0,2,1,0,0,0,0,0,1
1,0,0,0,0,0,0,0,0,0,0,0,0,1,0,0,0,0,0,1
1,2,0,0,0,0,0,0,1,18,0,0,20,1,0,0,0,0,0,1
1,19,0,0,0,0,0,20,1,0,0,0,20,1,0,0,0,2,16,1
1,1,1,1,1,1,1,1,1,1,1,1,1,1,1,1,1,1,1,1
